11
0 5
10 3
...........
.#########.
.#...#...#.
.#.#.#.#.#.
.#.#.#.#.#.
.#.#.#.#.#.
.#.#.#.#.#.
.#.#.#.#.#.
.#.#.#.#.#.
...#...#...
###.#######
