15
0 7
14 0
#######.#######
...............
.#############.
.....#####.....
.#############.
.....#####.....
.....#####.....
.....#####.....
.....#####.....
.....#####.....
.....#####.....
....#######....
...#########...
..###########..
.#############.
