20
0 19
2 19
....................
.##################.
.#...#...#...#...#..
.#.#.#.#.#.#.#.#.#.#
.#.#.#.#.#.#.#.#.#.#
.#.#.#.#.#.#.#.#.#.#
.#.#.#.#.#.#.#.#.#.#
.#.#.#.#.#.#.#.#.#.#
.#.#.#.#.#.#.#.#.#.#
.#.#.#.#.#.#.#.#.#.#
.#.#.#.#.#.#.#.#.#.#
.#.#.#.#.#.#.#.#.#.#
.#.#.#.#.#.#.#.#.#.#
.#.#.#.#.#.#.#.#.#.#
.#.#.#.#.#.#.#.#.#.#
.#.#.#.#.#.#.#.#.#.#
.#.#.#.#.#.#.#.#.#.#
.#.#.#.#.#.#.#.#.#.#
.#.#.#.#.#.#.#.#.#.#
...#...#...#...#...#