20
0 0 
18 18
.###################
.#.................#
.#.#.#.#.#.#.#.#.#.#
.#.#.#.#.#.#.#.#.#.#
.#.#.#.#.#.#.#.#.#.#
.#.#.#.#.#.#.#.#.#.#
.#.#.#.#.#.#.#.#.#.#
.#.#.#.#.#.#.#.#.#.#
.#.#.#.#.#.#.#.#.#.#
.#.#.#.#.#.#.#.#.#.#
.#.#.#.#.#.#.#.#.#.#
.#.#.#.#.#.#.#.#.#.#
.#.#.#.#.#.#.#.#.#.#
.#.#.#.#.#.#.#.#.#.#
.#.#.#.#.#.#.#.#.#.#
.#.#.#.#.#.#.#.#.#.#
.#.#.#.#.#.#.#.#.#.#
.#.#.#.#.#.#.#.#.#.#
.#.#.#.#.#.#.#.#.#.#
...#################